11111111111111111
100C0000000000001
1000000C0000C0001
10000001110C00001
10000C00000000P01
10000000C0000E001
11111111111111111