11111111111111111
100C0000000000001
100000000000C0001
10000011100C00001
10000C00000000001
10000000C0P00E001
11111111111111111