111111111111111111111111111111111111111111111111111111111111
1P00CCC0C000CCC0C000CCC0C000CCC0C000CCC0C000CCC0C000CCC0C0E1
111111111111111111111111111111111111111111111111111111111111