11111111111111111
100C000T000000001
1000000C01T0C0001
10000001110C00001
10000C00000000P01
10000000C00000E01
11111111111111111