111111111111111
1C000T00000T001
10000C01T0C0001
100001110C0T001
100C00000000P01
100000TC0000E01
111111111111111