11111
11111
11111
1E001
1C001
1P001
1C11111
