11111
11111
11T11
1E001
1C001
1P001
11111
